* * **********
*E           *
***    *  *  *
*  **  *  ** *
***** * * ** *
**           *
*            *
**    ********
*            *
**           *
*            *
************ *
*            *
*S ** *  *** *
**************