**S****
**  *E*
*  ** *
** ** *
**    *