******************E
**************** * 
S  **********   *  
 * ********** * ** 
 * *********  * ** 
 *      ** *  * ** 
 ******    *  *    
      ******  *    
                ** 
******************